X X X X X X X X X X
X D         X     X
X   X       X     X
X X X             X
X   X       X X X X
X                 X
X                 X
X X X X X     X X X
X       D       P X
X X X X X X X X X X